111111111111
101100P00001
1100C0110001
1E1010000C01
111111111111