111111111111
101101P10001
1100C0110011
1E0010001C11
111111111111