111111111111
100000P00001
1110C0000001
1E1010001C01
111111111111