111111111111
1000000P0001
10C0000000P1
100000E00001
111111111111