11111111111
100E0000001
100011000C1
1E00000P001
11111111111