111111111111
100P00C00001
10001001E001
100001100001
111111111111