111111111111
100P001000C1
10100000E001
11C000101001
111111111111