111111111111
100P00C00011
10001000E001
10C000000011
111111111111