1111111111111111111111111111
10C0000000000000000000000001
1000011100000000001111000011
10000000000000000000000C0001
10000000000111100E0000000001
1000000000000000000000000111
1111111111111110000000000001
1000000C01111000000000000001
100001100P000000000011111001
100000000000000000000C000001
1000000000C00000000111111001
1000C00000001111000000000001
1000000000000000000000000001
1010010100100C00101001000001
1111111111111111111111111111
