1111111111111111111111111111
100000000000000C00000C000001
100001110000E000000000000011
1000000000000000000000000001
100000000C00C000000000000001
1000000000000000000000000111
100000000000000C00000C000001
1000000000000000000000000001
1000000000000000000000000001
10000000000000000000P0000001
1000000000000C00000000000001
100000000000000000C000000001
100000C000000000000000000001
1010010100100000101001000001
1111111111111111111111111111



