1111111111111111111111111111
1000000000000000000000000001
1000011100000000000000000011
1000000000000000000000000001
10000000000000000E0000000001
1000000000000000000000000111
1000000000000000000000000001
1000000000000000000000000001
100000000000000P000000000001
1000000000000000000000000001
1000000000C00000000000000001
1000000000000000000000000001
1000000000000000000000000001
1010010100100000101001000001
1111111111111111111111111111
