11111111111
1000000P001
1E000000001
10000000001
11111111111